16
234
5 5  5 5  9 7 7 7 7 7 7 7 7 7 7 7 7 10 5 5 5 5 5 5 5  5 5 5 5 5 5 5 5 5 5 5 5 9 7 7 7 7 7 7 7 7  7 7 7 7 7 7 10 5 5 5  5 5 5 5 5 5 5 5 5 5 5 5 5 5 5 5  5 5  5 5 5 9 7 7 7 7  7 7 7 7  7 7 7 7 7 7 7 7 10 5 5 5 5 5 5 5 5 5 5 5  5 5 5 5 5 5 5 5 5 9 7 7 7 7  7 7 7 7 7 7 7 7 10 5 5 5 5 5  5 5 5 5 5 5  5 5 5 5 5 5 5 5 5 5 5 5 5 5 5 5 5 5 5  5 5 5 5 9 7 7 7 7 7 7 7 7 7 7 7 7 7 7 7 7 7  7 7 7 7 7 7 7 7 7 7 7 7 7 7 7 7 7 7 7 7 7 7 7 7 7  7 7 7 7  7 7 7 7 7 7 7 7 7 7 7 7 7 7 7 7 7 7 7 7 7 7 7 10 																																																																																																															
5 5  5 5  9 7 7 7 7 7 7 7 7 7 7 7 7 10 5 5 5 5 5 5 5  5 5 5 5 5 5 5 5 5 5 5 5 9 7 7 7 7 7 7 7 7  7 7 7 7 7 7 10 5 5 5  5 5 5 5 5 5 5 5 5 5 5 5 5 5 5 5  5 5  5 5 5 9 7 7 7 7  7 7 7 7  7 7 7 7 7 7 7 7 10 5 5 5 5 5 5 5 5 5 5 5  5 5 5 5 5 5 5 5 5 9 7 7 7 7  7 7 7 7 7 7 7 7 10 5 5 5 5 5  5 5 5 5 5 5  5 5 5 5 5 5 5 5 5 5 5 5 5 5 5 5 5 5 5  5 5 5 5 9 7 7 7 7 7 7 7 7 7 7 7 7 7 7 7 7 7  7 7 7 7 7 7 7 7 7 7 7 7 7 7 7 7 7 7 7 7 7 7 7 7 7  7 7 7 7  7 7 7 7 7 7 7 7 7 7 7 7 7 7 7 7 7 7 7 7 7 7 7 10 																																																																																					
5 5  5 5  9 7 7 7 7 7 7 7 7 7 7 7 7 10 5 5 5 5 5 5 5  5 5 5 5 5 5 5 5 5 5 5 5 9 7 7 7 7 7 7 7 7  7 7 7 7 7 7 10 5 5 5  5 5 5 5 5 5 5 5 5 5 5 5 5 5 5 5  5 5  5 5 5 9 7 7 7 7  7 7 7 7  7 7 7 7 7 7 7 7 10 5 5 5 5 5 5 5 5 5 5 5  5 5 5 5 5 5 5 5 5 9 7 7 7 7  7 7 7 7 7 7 7 7 10 5 5 5 5 5  5 5 6 5 5 5  5 5 5 5 5 5 5 5 5 5 5 5 5 5 5 5 5 5 5  5 5 5 5 9 7 7 7 7 7 7 7 7 7 7 7 7 7 7 7 7 7  7 7 7 7 7 7 7 7 7 7 7 7 7 7 7 7 7 7 7 7 7 7 7 7 7  7 7 7 7  7 7 7 7 7 7 7 7 7 7 7 7 7 7 7 7 7 7 7 7 7 7 7 10 																																																																							
5 5  5 5  9 7 7 7 7 7 7 7 7 7 7 7 7 10 5 5 5 5 5 5 5  5 5 5 5 5 5 5 5 5 5 5 5 9 7 7 7 7 7 7 7 7  7 7 7 7 7 7 10 5 5 5  5 5 5 5 13 5 5 5 5 5 5 5 5 5 5 5  5 5  5 5 5 9 7 7 7 7  7 7 7 7 10 5 5 5 5 5 5 5  5 5 5 5 5 5 5 5 5 5 5 5  5 5 5 5 5 5 5 5 5 9 7 7 7 7  7 7 7 7 7 7 7 7  7 1 2 5 5 5  5 3 1 1 1 1  4 5 5 5 5 5 5 5 5 5 5 5 5 5 5 5 5 5 5  5 5 5 5 9 7 7 7 7 7 7 7 7 7 7 7 7 7 7 7 7 7  7 7 7 7 7 7 7 7 7 7 7 7 7 7 7 7 7 7 7 7 7 7 7 7 7  7 7 7 7 10 5 5 5 5 5 5 5 5 5 5 5 5 5 5 5 5 5 9 7 7 7 7 10																																																																																	
5 5  5 5  9 7 7 7 7 7 7 7 7 7 7 7 7 10 5 5 5 5 5 5 5  5 5 5 5 5 5 5 5 5 5 5 5 9 7 7 7 7 7 7 7 7 10 5 5 5 5 5  5 5 5 5  5 5 5 5 5 5 5 5 5 5 5 5 5 5 5 5 11 5  5 5 5 9 7 7 7 7  7 7 7 7 10 5 5 5 5 5 5 5  5 5 5 5 5 5 5 5 5 5 5 5  5 5 5 5 5 5 5 5 5 5 5 5 5 5  5 5 5 5 9 7 7 7 10 5 5 5 5 5  5 9 7 7 7 7 10 5 5 5 5 5 5 5 5 5 5 5 5 5 5 5 5 5 5  5 5 5 5 9 7 7 7 7 7 7 7 7 7 7 7 7 7 7 7 7 7  7 7 7 7 7 7 7 7 7 7 7 7 7 7 7 7 7 7 7 7 7 7 7 7 7  7 7 7 7 10 5 5 5 5 5 5 5 5 5 5 5 5 5 5 5 5 5 9 7 7 7 7 10 																																																											
5 5  5 5  5 5 5 5 5 5 5 5 5 5 5 5 5  5 5 5 5 5 5 5 5  5 5 5 5 5 5 5 5 5 5 5 5 9 7 7 7 7 7 7 7 7 10 5 5 5 5 5  5 5 5 5  5 5 5 5 5 5 5 5 3 1 1 1 1 1 1 1  1 1  4 5 5 9 7 7 7 7 10 5 5 5  5 5 5 5 5 5 5 5  5 5 5 5 5 5 5 5 5 5 5 5  5 5 5 5 5 5 5 5 5 5 5 5 5 5  5 5 5 5 9 7 7 7 10 5 5 5 5 0  1 7 7 7 7 7 10 5 5 5 5 5 5 5 5 5 5 5 5 5 5 5 5 5 5  5 5 5 5 9 7 7 7 7 7 7 7 7 7 7 7 7 7 7 7 7 7  7 7 7 7 7 7 7 7 7 7 7 7 7 7 7 7 7 7 7 7 7 7 7 7 7  7 7 7 7 10 5 5 5 5 5 5 5 5 5 5 5 5 5 5 5 5 5 9 7 7 7 7 10 																																																																																																				
5 5  5 5  5 5 5 5 5 5 5 5 5 5 5 5 5  5 5 5 12 5 5 5 5  5 5 5 5 5 5 5 5 5 5 5 5 5 5 5 5 5 5 5 5 5  5 5 5 5 5 5  5 5 5 5  5 5 5 5 5 5 5 5 9 7 7 7 7 7 7 7  7 7 10 5 5 9 7 7 7 7 10 5 5 5  5 5 5 5 5 5 5 5  5 5 5 5 5 5 5 5 5 5 5 5  5 5 5 5 5 5 5 5 5 5 5 5 5 5  5 5 5 5 9 7 7 7 10 5 5 5 5 5  5 9 7 7 7 7 10 5 5 5 5 5 5 5 5 5 5 5 5 5 5 5 5 5 5  5 5 5 5 9 7 7 7 7 7 7 7 7 7 7 7 7 7 7 7 7 7  7 7 7 7 7 7 7 7 7 7 7 7 7 7 7 7 7 7 7 7 7 7 7 7 7  7 7 7 7 10 5 5 5 5 5 5 5 5 5 5 5 5 5 5 5 5 5 9 7 7 7 7 10 																																																																																																							
5 5  5 5  5 5 5 5 5 5 5 5 5 5 5 5 5  5 5 5 5 5 5 5 5  5 5 5 5 5 5 5 5 5 5 5 5 5 5 5 5 5 5 5 5 5  5 5 5 5 5 5  5 5 5 5  5 5 5 3 1 1 1 1 7 7 7 7 7 7 7 7  7 7 10 5 5 9 7 7 7 7 10 5 5 5  5 5 5 5 5 5 3 1  4 5 5 0 1 1 1 2 5 5 5 5  5 5 5 5 5 5 5 5 5 5 5 5 5 6  5 5 5 5 9 7 7 7  7 1 2 5 5 5  5 9 7 7 7 7 10 5 5 5 5 5 5 5 5 5 5 5 5 5 5 5 5 5 5  5 5 5 5 9 7 7 7 7 7 7 7 7 7 7 7 7 7 7 7 7 7  7 7 7 7 7 7 7 7 7 7 7 7 7 7 7 7 7 7 7 7 7 7 7 7 7  7 7 7 7 10 5 5 5 5 5 5 5 5 5 5 5 5 5 5 5 5 5 9 7 7 7 7 10 																																																																																										
5 5  5 5  5 5 5 5 5 5 5 5 5 5 5 5 5  5 5 5 5 5 5 5 5  5 5 5 5 5 5 5 5 5 5 5 5 5 5 5 5 5 5 5 5 5  5 5 5 5 5 5  5 5 5 5 11 5 5 9 7 7 7 7 7 7 7 7 7 7 7 7  7 7 10 5 5 9 7 7 7 7 10 5 5 5  5 5 5 5 5 5 9 7 10 5 5 5 5 5 5 5 5 5 5 5 11 5 5 5 5 0 1 1 1 1 1 1 1 1  4 5 5 5 9 7 7 7 10 5 5 5 5 5 11 9 7 7 7 7 10 5 5 5 5 5 5 5 6 5 5 5 5 5 5 5 5 5 5  5 5 5 5 9 7 7 7 7 7 7 7 7 7 7 7 7 7 7 7 7 7  7 7 7 7 7 7 7 7 7 7 7 7 7 7 7 7 7 7 7 7 7 7 7 7 7  7 7 7 7 10 5 5 5 5 5 5 5 5 5 5 5 5 5 5 5 5 5 9 7 7 7 7 10 																																																																																																			
5 5  5 5  5 5 5 5 5 5 5 5 5 5 6 5 5  5 5 5 5 5 5 5 5 11 5 5 5 0 1 2 5 5 5 5 5 5 5 5 5 5 5 5 5 5  5 5 5 5 5 5  5 3 1 1  1 1 1 7 7 7 7 7 7 7 7 7 7 7 7 7  7 7 10 5 5 5 5 5 5 5  5 5 5 5  5 5 5 3 1 1 7 7 10 5 5 5 5 5 5 5 5 5 0 1  1 1 2 5 5 5 5 5 5 9 7 7 7 7 10 5 5 5 9 7 7 7 10 5 5 5 5 0  1 7 7 7 7 7 10 5 5 5 5 0 1 1 1 1 2 5 5 5 5 5 5 5 5  5 5 5 5 9 7 7 7 7 7 7 7 7 7 7 7 7 7 7 7 7 7  7 7 7 7 7 7 7 7 7 7 7 7 7 7 7 7 7 7 7 7 7 7 7 7 7  7 7 7 7 10 5 5 5 5 5 5 5 5 5 5 5 5 5 5 5 5 5 9 7 7 7 7 10 																																																																																																																
5 5  5 5  5 5 5 5 5 5 5 5 0 1 1 2 5  5 5 5 5 5 5 5 0  1 2 5 5 5 5 5 5 5 5 5 5 5 5 5 5 5 5 5 5 5  5 5 5 5 5 5  5 9 7 7  7 7 7 7 7 7 7 7 7 7 7 7 7 7 7 7  7 7 10 5 5 5 5 5 5 5  5 5 5 5  5 5 5 9 7 7 7 7 10 5 5 5 5 5 5 5 5 5 5 5  5 5 5 5 5 5 5 5 5 9 7 7 7 7 10 5 5 5 9 7 7 7 10 5 5 5 5 5  5 9 7 7 7 7 10 5 5 5 5 5 5 5 5 5 5 5 5 5 5 5 5 5 5  5 5 5 5 5 5 5 5 5 5 5 5 5 5 5 5 5 5 5 5 5 5  5 5 5 5 5 5 5 5 5 5 5 5 5 5 5 5 5 5 5 5 5 5 5 5 5  5 5 5 5  5 5 5 5 5 5 5 5 5 5 5 5 5 5 5 5 5 5 9 7 7 7 7 10 																																																																																																														
5 5  5 5  5 5 5 5 5 5 5 5 5 5 5 5 5  5 0 1 1 2 5 5 5  5 5 5 5 5 5 5 5 5 0 1 2 5 5 5 5 5 5 5 5 5  5 5 5 5 3 1  1 7 7 7  7 7 7 7 7 7 7 7 7 7 7 7 7 7 7 7  7 7 10 5 5 5 5 5 5 5  5 5 5 5  3 1 1 7 7 7 7 7 10 5 5 5 5 5 5 5 5 5 5 5  5 5 5 5 5 5 5 5 5 9 7 7 7 7 10 5 5 5 9 7 7 7  7 1 2 5 5 5  5 9 7 7 7 7 10 5 5 5 5 5 5 5 5 5 5 5 5 5 5 5 5 5 5  5 5 5 5 5 5 5 5 5 5 5 5 5 5 5 5 5 5 5 5 5 5  5 5 5 5 5 5 5 5 5 5 5 5 5 5 5 5 5 5 5 5 5 5 5 5 5  5 5 5 5  5 5 5 5 5 5 5 5 5 5 5 5 5 5 5 5 5 5 9 7 7 7 7 10 																																																																																																
5 5  5 5  5 5 0 1 1 2 5 5 5 5 5 5 5  5 5 5 5 5 5 5 5  5 5 5 5 5 5 5 5 5 5 5 5 5 5 5 5 5 5 5 5 5  5 5 5 5 9 7  7 7 7 7  7 7 7 7 7 7 7 7 7 7 7 7 7 7 7 7  7 7 10 5 5 5 5 5 5 5  5 5 6 5  9 7 7 7 7 7 7 7 10 5 5 5 5 5 5 5 5 5 5 5  5 5 5 5 5 5 5 5 5 9 7 7 7 7 10 5 5 5 5 5 5 5  5 5 5 5 5 5  5 9 7 7 7 7 10 5 5 5 5 5 5 5 5 5 5 5 5 5 5 5 5 5 5  5 5 5 5 5 5 5 5 5 5 5 5 5 5 5 5 5 5 5 5 5 5  5 5 5 5 5 5 5 5 5 5 5 5 5 5 5 5 5 5 5 5 5 5 5 5 5  5 5 5 5  5 5 5 5 5 5 5 5 5 5 5 5 5 5 5 5 5 5 9 7 7 7 7 10 																																																																															
1 1  4 5  5 5 5 5 5 5 5 5 5 5 5 5 5  5 5 5 5 5 5 5 5  5 5 5 5 5 5 5 5 5 5 5 5 5 5 5 5 5 5 5 5 5  5 3 1 1 7 7  7 7 7 7  7 7 7 7 7 7 7 7 7 7 7 7 7 7 7 7  7 7  7 1 1 1 1 1 1 1  1 1 1 1  7 7 7 7 7 7 7 7 10 5 5 5 5 5 5 5 5 5 5 5  5 5 5 5 5 5 5 5 5 9 7 7 7 7 10 5 5 5 5 5 5 5  5 5 5 5 5 3  1 7 7 7 7 7 10 5 5 5 5 5 5 5 5 5 5 5 5 5 5 5 5 5 5  5 5 5 5 5 5 5 5 5 5 5 5 5 5 5 5 5 5 5 5 5 5  5 5 5 5 5 5 5 5 5 5 5 5 5 5 5 5 5 5 5 5 5 5 5 5 5  5 5 5 5  5 5 5 5 5 5 5 5 5 5 5 5 5 5 5 5 5 5 9 7 7 7 7 10 																																																																																																
7 7 10 5 11 5 5 5 5 5 5 5 5 5 5 5 5  5 5 5 5 5 5 5 5  5 5 5 5 5 5 5 5 5 5 5 5 5 5 5 5 5 5 5 6 5  5 9 7 7 7 7  7 7 7 7  7 7 7 7 7 7 7 7 7 7 7 7 7 7 7 7  7 7  7 7 7 7 7 7 7 7  7 7 7 7  7 7 7 7 7 7 7 7 10 5 5 5 5 5 5 5 5 5 5 5  5 5 5 5 5 5 5 5 5 9 7 7 7 7 10 5 5 5 5 5 5 5 11 5 5 5 5 9  7 7 7 7 7 7 10 5 5 5 5 5 5 5 5 5 5 5 5 5 5 5 5 5 5 11 5 5 5 5 5 5 6 5 5 5 5 5 5 6 5 5 5 5 5 5 5 11 5 5 5 5 5 5 5 5 5 6 5 5 5 5 5 6 5 5 6 5 5 6 5 5  5 5 5 5  5 5 5 5 5 5 5 5 5 5 5 5 5 5 5 5 5 5 9 7 7 7 7 10																																																																																																										
7 7 7  1  1 4 5 5 5 5 5 5 5 5 5 5 5  5 5 5 5 5 5 5 5  5 5 5 5 5 5 5 5 5 5 5 5 5 5 5 3 1 1 1 1 1  1 7 7 7 7 7  7 7 7 7  7 7 7 7 7 7 7 7 7 7 7 7 7 7 7 7  7 7  7 7 7 7 7 7 7 7  7 7 7 7  7 7 7 7 7 7 7 7 10 5 5 5 5 5 5 5 5 5 5 5  5 5 5 5 5 5 5 5 5 9 7 7 7 7  7 1 1 1 1 1 1 1  1 1 1 1 1 7  7 7 7 7 7 7 10 5 5 5 5 5 5 5 5 5 5 5 5 5 5 0 1 1 1  1 1 1 1 1 1 1 1 4 5 5 3 1 1 1 4 5 5 3 1 1 1  1 1 1 1 4 5 5 3 1 1 1 4 5 5 3 1 1 1 1 1 1 1 1 1 4  5 5 3 1  1 1 1 1 1 1 1 1 1 1 1 1 1 1 1 1 1 1 7 7 7 7 7 10																																																																																																																												